****************************
*..........................*
*..........................*
*...A......................*
*........................D.*
*.....**********...........*
*..............*...........*
*..............*...........*
*..............*...........*
*..............*...........*
****************************