****************************
*..........................*
*...............****.......*
*..........................*
*..........................*
*.....**********...........*
*..AA..........*...........*
*..A...........*...........*
*..............*...........*
*..............*...........*
*..........................*
*......D...................*
*..........................*
****************************