****************************
*..........................*
*...............****.......*
*..........................*
*......A.............A.....*
*.....**********...........*
*..............*...........*
*..............*...........*
*..............*...........*
*..............*...........*
*.....D....................*
*..........................*
*..........................*
****************************